| = = = = = = = = = = = = = = = = = = = = = = = = = = = = = = = = = = = = = = = = = = = = = = = = = = = = = = = = = = = = = = = = = = = = = = = = = = = = |
| v v v v v v v v v v v f f f f f f f f f f f f f f h h h h h h h h h h h h h h h h h h n n n n n n n n n n n n n n n n n o o o o o o o o o o o o o o o o |
| v v v v v v v v v v v f f f f f f f f f f f f f f h h h h h h h h h h h h h h h h h h n n n n n n n n n n n n n n n n n o o o o o o o o o o o o o o o o |
| v v v v v v v v v v v f f f f f f f f f f f f f f h h h h h h h h h h h h h h h h h h n n n n n n n n n n n n n n n n n o o o o o o o o o o o o o o o o |
| v v v v v v v v v v v f f f f f f f f f f f f f f h h h h h h h h h h h h h h h h h h n n n n n n n n n n n n n n n n n o o o o o o o o o o o o o o o o |
| v v v v v v v v v v v f f f f f f f f f f f f f f h h h h h h h h h h h h h h h h h h n n n n n n n n n n n n n n n n n o o o o o o o o o o o o o o o o |
| v v v v v v v v v v v f f f f f f f f f f f f f f h h h h h h h h h h h h h h h h h h n n n n n n n n n n n n n n n n n o o o o o o o o o o o o o o o o |
| v v v v v v v v v v v f f f f f f f f f f f f f f h h h h h h h h h h h h h h h h h h n n n n n n n n n n n n n n n n n o o o o o o o o o o o o o o o o |
| v v v v v v v v v v v f f f f f f f f f f f f f f h h h h h h h h h h h h h h h h h h n n n n n n n n n n n n n n n n n o o o o o o o o o o o o o o o o |
| f f f f f f f f f f f f f f f f f f f f f f f f f h h h h h h h h h h h h h h h h h h n n n n n n n n n n n n n n n n n o o o o o o o o o o o o o o o o |
| f f f f f f f f f f f f f f f f f f f f f f f f f h h h h h h h h h h h h h h h h h h n n n n n n n n n n n n n n n n n o o o o o o o o o o o o o o o o |
| f f f f f f f f f f f f f f f f f f f f f f f f f h h h h h h h h h h h h h h h h h h n n n n n n n n n n n n n n n n n o o o o o o o o o o o o o o o o |
| f f f f f f f f f f f f f f f f f f f f f f f f f h h h h h h h h h h h h h h h h h h n n n n n n n n n n n n n n n n n o o o o o o o o o o o o o o o o |
| f f f f f f f f f f f f f f f f f f f f f f f f f h h h h h h h h h h h h h h h h h h n n n n n n n n n n n n n n n n n o o o o o o o o o o o o o o o o |
| f f f f f f f f f f f f f f f f f f f f f f f f f h h h h h h h h h h h h h h h h h h n n n n n n n n n n n n n n n n n o o o o o o o o o o o o o o o o |
| f f f f f f f f f f f f f f f f f f f f f f f f f h h h h h h h h h h h h h h h h h h n n n n n n n n n n n n n n n n n o o o o o o o o o o o o o o o o |
| f f f f f f f f f f f f f f f f f f f f f f f f f h h h h h h h h h h h h h h h h h h n n n n n n n n n n n n n n n n n o o o o o o o o o o o o o o o o |
| f f f f f f f f f f f f f f f f f f f f f f f f f h h h h h h h h h h h h h h h h h h n n n n n n n n n n n n n n n n n o o o o o o o o o o o o o o o o |
| f f f f f f f f f f f f f f f f f f f f f f f f f h h h h h h h h h h h h h h h h h h n n n n n n n n n n n n n n n n n o o o o o o o o o o o o o o o o |
| f f f f f f f f f f f f f f f f f f f f f f f f f h h h h h h h h h h h h h h h h h h n n n n n n n n n n n n n n n n n o o o o o o o o o o o o o o o o |
| f f f f f f f f f f f f f f f f f f f f f f f f f h h h h h h h h h h h h h h h h h h n n n n n n n n n n n n n n n n n o o o o o o o o o o o o o o o o |
| f f f f f f f f f f f f f f f f f f f f f f f f f h h h h h h h h h h h h h h h h h h n n n n n n n n n n n n n n n n n o o o o o o o o o o o o o o o o |
| f f f f f f f f f f f f f f f f f f f f f f f f f h h h h h h h h h h h h h h h h h h n n n n n n n n n n n n n n n n n o o o o o o o o o o o o o o o o |
| f f f f f f f f f f f f f f f f f f f f f f f f f h h h h h h h h h h h h h h h h h h n n n n n n n n n n n n n n n n n o o o o o o o o o o o o o o o o |
| f f f f f f f f f f f f f f f f f f f f f f f f f h h h h h h h h h h h h h h h h h h n n n n n n n n n n n n n n n n n o o o o o o o o o o o o o o o o |
| f f f f f f f f f f f f f f f f f f f f f f f f f h h h h h h h h h h h h h h h h h h n n n n n n n n n n n n n n n n n o o o o o o o o o o o o o o o o |
| f f f f f f f f f f f f f f f f f f f f f f f f f h h h h h h h h h h h h h h h h h h n n n n n n n n n n n n n n n n n o o o o o o o o o o o o o o o o |
| f f f f f f f f f f f f f f f f f f f f f f f f f h h h h h h h h h h h h h h h h h h n n n n n n n n n n n n n n n n n o o o o o o o o o o o o o o o o |
| f f f f f f f f f f f f f f f f f f f f f f f f f h h h h h h h h h h h h h h h h h h n n n n n n n n n n n n n n n n n o o o o o o o o o o o o o o o o |
| r r r r r r r r r r r r r r r r r r r r r r r r r r r r r r r r r r r r r r r r r r r r r r r r r r r r r r r r r r r r r r r r r r - - - - - - - - - - |
| r r r r r r r r r r r r r r r r r r r r r r r r r r r r r r r r r r r r r r r r r r r r r r r r r r r r r r r r r r r r r r r r r r d d d d d d d d d d |
| r r r r r r r r r r r r r r r r r r r r r r r r r r r r r r r r r r r r r r r r r r r r r r r r r r r r r r r r r r r r r r r r r r d d d d d d d d d d |
| r r r r r r r r r r r r r r r r r r r r r r r r r r r r r r r r r r r r r r r r r r r r r r r r r r r r r r r r r r r r r r r r r r d d d d d d d d d d |
| r r r r r r r r r r r r r r r r r r r r r r r r r r r r r r r r r r r r r r r r r r r r r r r r r r r r r r r r r r r r r r r r r r d d d d d d d d d d |
| D T B B d d d d d d d d d d d d d d d d d d d d d d d d d d d d d d d d d d d d d d d d d d d d d d d d d d d d d d d d d d d d d d d d d d d d d d d d |
| E O B B d d d d d d d d d d d d d d d d d d d d d d d d d d d d d d d d d d d d d d d d d d d d d d d d d d d d d d d d d d d d d d d d d d d d d d d d |
| M W B B d d d d d d d d d d d d d d d d d d d d d d d d d d d d d d d d d d d d d d d d d d d d d d d d d d d d d d d d d d d d d d d d d d d d d d d d |
| O E B B d d d d d d d d d d d d d d d d d d d d d d d d d d d d d d d d d d d d d d d d d d d d d d d d d d d d d d d d d d d d d d d d d d d d d d d d |
| N R B B d d d d d d d d d d d d d d d d d d d d d d d d d d d d d d d d d d d d d d d d d d d d d d d d d d d d d d d d d d d d d d d d d d d d d d d d |
| = = = = = = = = = = = = = = = = = = = = = = = = = = = = = = = = = = = = = = = = = = = = = = = = = = = = = = = = = = = = = = = = = = = = = = = = = = = = |